time
2021-12-22
2021-12-23
2021-12-24
2021-12-25
2021-12-26
2021-12-27
2021-12-28
2021-12-29
2021-12-30
2021-12-31
2022-01-10
2022-01-11
2022-01-12
2022-01-13
2022-01-14
2022-01-15
2022-04-11
2022-04-12
2022-04-13
2022-04-14
2022-04-15
2022-05-01
2022-05-02
2022-05-03
2022-05-04
2022-05-05
2022-05-06
2022-05-07
2022-05-08
2022-05-09
2022-05-10
2022-05-15
